1:1 1:1 1:1 1:1 1:1 1:1 1:1 1:1 1:1 1:1 1:1 1:1 1:1 1:1 1:1 1:1 1:1 1:1 1:1 1:1 2:0 2:0 2:0 1:1 1:1 1:1 1:1 1:1 1:1 1:1 1:1 1:1 1:1 1:1 1:1 1:1 1:1 1:1 1:1 1:1 1:1 1:1 1:1 1:1 1:1 1:1 1:1 1:1 1:1 1:1 
1:1 2:0 2:0 2:0 2:0 2:0 2:0 2:0 2:0 2:0 2:0 2:0 2:0 2:0 2:0 2:0 2:0 2:0 2:0 2:0 2:0 2:0 2:0 2:0 2:0 2:0 2:0 2:0 2:0 2:0 2:0 2:0 2:0 2:0 2:0 2:0 2:0 2:0 2:0 2:0 2:0 2:0 2:0 2:0 2:0 2:0 2:0 2:0 2:0 1:1
1:1 2:0 2:0 2:0 2:0 2:0 2:0 2:0 2:0 2:0 2:0 2:0 2:0 2:0 2:0 2:0 2:0 2:0 2:0 2:0 2:0 2:0 2:0 2:0 2:0 2:0 2:0 2:0 2:0 2:0 2:0 2:0 2:0 2:0 2:0 2:0 2:0 2:0 2:0 2:0 2:0 2:0 2:0 2:0 2:0 2:0 2:0 2:0 2:0 1:1
1:1 2:0 2:0 2:0 2:0 2:0 2:0 2:0 2:0 2:0 2:0 2:0 2:0 2:0 2:0 2:0 2:0 2:0 2:0 2:0 2:0 2:0 2:0 2:0 2:0 2:0 2:0 2:0 2:0 2:0 2:0 2:0 2:0 2:0 2:0 2:0 2:0 2:0 2:0 2:0 2:0 2:0 2:0 2:0 2:0 2:0 2:0 2:0 2:0 1:1
1:1 2:0 2:0 2:0 2:0 2:0 2:0 2:0 2:0 2:0 2:0 2:0 2:0 2:0 2:0 2:0 2:0 2:0 2:0 2:0 2:0 2:0 2:0 2:0 2:0 2:0 2:0 2:0 2:0 2:0 2:0 2:0 2:0 2:0 2:0 2:0 2:0 2:0 2:0 2:0 2:0 2:0 2:0 2:0 2:0 2:0 2:0 2:0 2:0 1:1
1:1 2:0 2:0 2:0 2:0 2:0 2:0 2:0 2:0 2:0 2:0 2:0 2:0 2:0 2:0 2:0 2:0 2:0 2:0 2:0 2:0 2:0 2:0 2:0 2:0 2:0 2:0 2:0 2:0 2:0 2:0 2:0 2:0 2:0 2:0 2:0 2:0 2:0 2:0 2:0 2:0 2:0 2:0 2:0 2:0 2:0 2:0 2:0 2:0 1:1
1:1 2:0 2:0 2:0 2:0 2:0 2:0 2:0 2:0 2:0 2:0 2:0 2:0 2:0 2:0 2:0 2:0 2:0 2:0 2:0 2:0 2:0 2:0 2:0 2:0 2:0 2:0 2:0 2:0 2:0 2:0 2:0 2:0 2:0 2:0 2:0 2:0 2:0 2:0 2:0 2:0 2:0 2:0 2:0 2:0 2:0 2:0 2:0 2:0 1:1
1:1 2:0 2:0 2:0 2:0 2:0 2:0 2:0 2:0 2:0 2:0 2:0 2:0 2:0 2:0 2:0 2:0 2:0 2:0 2:0 2:0 2:0 2:0 2:0 2:0 2:0 2:0 2:0 2:0 2:0 2:0 2:0 2:0 2:0 2:0 2:0 2:0 2:0 2:0 2:0 2:0 2:0 2:0 2:0 2:0 2:0 2:0 2:0 2:0 1:1
1:1 2:0 2:0 2:0 2:0 2:0 2:0 2:0 2:0 2:0 2:0 2:0 2:0 2:0 2:0 2:0 2:0 2:0 2:0 2:0 2:0 2:0 2:0 2:0 2:0 2:0 2:0 2:0 2:0 2:0 2:0 2:0 2:0 2:0 2:0 2:0 2:0 2:0 2:0 2:0 2:0 2:0 2:0 2:0 2:0 2:0 2:0 2:0 2:0 1:1
1:1 2:0 2:0 2:0 2:0 2:0 2:0 2:0 2:0 2:0 2:0 2:0 2:0 2:0 2:0 2:0 2:0 2:0 2:0 2:0 2:0 2:0 2:0 2:0 2:0 2:0 2:0 2:0 2:0 2:0 2:0 2:0 2:0 2:0 2:0 2:0 2:0 2:0 2:0 2:0 2:0 2:0 2:0 2:0 2:0 2:0 2:0 2:0 2:0 1:1
1:1 2:0 2:0 2:0 2:0 2:0 2:0 2:0 2:0 2:0 2:0 2:0 2:0 2:0 2:0 2:0 2:0 2:0 2:0 2:0 2:0 2:0 2:0 2:0 2:0 2:0 2:0 2:0 2:0 2:0 2:0 2:0 2:0 2:0 2:0 2:0 2:0 2:0 2:0 2:0 2:0 2:0 2:0 2:0 2:0 2:0 2:0 2:0 2:0 1:1
1:1 2:0 2:0 2:0 2:0 2:0 2:0 2:0 2:0 2:0 2:0 2:0 4:1 4:1 4:1 4:1 4:1 2:0 2:0 2:0 2:0 2:0 2:0 2:0 2:0 2:0 2:0 2:0 2:0 2:0 2:0 2:0 2:0 2:0 2:0 2:0 2:0 2:0 2:0 2:0 2:0 2:0 2:0 2:0 2:0 2:0 2:0 2:0 2:0 1:1
1:1 2:0 2:0 2:0 2:0 2:0 2:0 2:0 2:0 2:0 2:0 2:0 4:1 4:1 4:1 4:1 4:1 2:0 2:0 2:0 2:0 2:0 2:0 2:0 2:0 2:0 2:0 2:0 2:0 2:0 2:0 2:0 2:0 2:0 2:0 2:0 2:0 2:0 2:0 2:0 2:0 2:0 2:0 2:0 2:0 2:0 2:0 2:0 2:0 1:1
1:1 2:0 2:0 2:0 2:0 2:0 2:0 2:0 2:0 2:0 2:0 2:0 4:1 4:1 4:1 4:1 4:1 2:0 2:0 2:0 2:0 2:0 2:0 2:0 2:0 2:0 2:0 2:0 2:0 2:0 2:0 2:0 2:0 2:0 2:0 2:0 2:0 2:0 2:0 2:0 2:0 2:0 2:0 2:0 2:0 2:0 2:0 2:0 2:0 1:1
1:1 2:0 2:0 2:0 2:0 2:0 2:0 2:0 2:0 2:0 2:0 2:0 4:1 4:1 4:1 4:1 4:1 2:0 2:0 2:0 2:0 2:0 2:0 2:0 2:0 2:0 2:0 2:0 2:0 2:0 2:0 2:0 2:0 2:0 2:0 2:0 2:0 2:0 2:0 2:0 2:0 2:0 2:0 2:0 2:0 2:0 2:0 2:0 2:0 1:1
2:0 2:0 2:0 2:0 2:0 2:0 2:0 2:0 2:0 2:0 2:0 2:0 4:1 4:1 4:1 4:1 4:1 2:0 2:0 2:0 2:0 2:0 2:0 2:0 2:0 2:0 2:0 2:0 2:0 2:0 2:0 2:0 2:0 2:0 2:0 2:0 2:0 2:0 2:0 2:0 2:0 2:0 2:0 2:0 2:0 2:0 2:0 2:0 2:0 2:0
2:0 2:0 2:0 2:0 2:0 2:0 2:0 2:0 2:0 2:0 2:0 2:0 2:0 2:0 2:0 2:0 2:0 2:0 2:0 2:0 2:0 2:0 2:0 2:0 2:0 2:0 2:0 2:0 2:0 2:0 2:0 2:0 2:0 2:0 2:0 2:0 2:0 2:0 2:0 2:0 2:0 2:0 2:0 2:0 2:0 2:0 2:0 2:0 2:0 2:0
2:0 2:0 2:0 2:0 2:0 2:0 2:0 2:0 2:0 2:0 2:0 2:0 2:0 2:0 2:0 2:0 2:0 2:0 2:0 2:0 2:0 2:0 2:0 2:0 2:0 2:0 2:0 2:0 2:0 2:0 2:0 2:0 2:0 2:0 2:0 2:0 2:0 2:0 2:0 2:0 2:0 2:0 2:0 2:0 2:0 2:0 2:0 2:0 2:0 2:0
2:0 2:0 2:0 2:0 2:0 2:0 2:0 2:0 2:0 2:0 2:0 2:0 2:0 2:0 2:0 2:0 2:0 2:0 2:0 2:0 2:0 2:0 2:0 2:0 2:0 2:0 2:0 2:0 2:0 2:0 2:0 2:0 2:0 2:0 2:0 2:0 2:0 2:0 2:0 2:0 2:0 2:0 2:0 2:0 2:0 2:0 2:0 2:0 2:0 2:0
1:1 2:0 2:0 2:0 2:0 2:0 2:0 2:0 2:0 2:0 2:0 2:0 2:0 2:0 2:0 2:0 2:0 2:0 2:0 2:0 2:0 2:0 2:0 2:0 2:0 2:0 2:0 2:0 2:0 2:0 2:0 2:0 2:0 2:0 2:0 2:0 2:0 2:0 2:0 2:0 2:0 2:0 2:0 2:0 2:0 2:0 2:0 2:0 2:0 1:1
1:1 2:0 2:0 2:0 2:0 2:0 2:0 2:0 2:0 2:0 2:0 2:0 2:0 2:0 2:0 2:0 2:0 2:0 2:0 2:0 2:0 2:0 2:0 2:0 2:0 2:0 2:0 2:0 2:0 2:0 2:0 2:0 2:0 2:0 2:0 2:0 2:0 2:0 2:0 2:0 2:0 2:0 2:0 2:0 2:0 2:0 2:0 2:0 2:0 1:1
1:1 2:0 2:0 2:0 2:0 2:0 2:0 2:0 2:0 2:0 2:0 2:0 2:0 2:0 2:0 2:0 2:0 2:0 2:0 2:0 2:0 2:0 2:0 2:0 2:0 2:0 2:0 2:0 2:0 2:0 2:0 2:0 2:0 2:0 2:0 2:0 2:0 2:0 2:0 2:0 2:0 2:0 2:0 2:0 2:0 2:0 2:0 2:0 2:0 1:1
1:1 2:0 2:0 2:0 2:0 2:0 2:0 2:0 2:0 2:0 2:0 2:0 2:0 2:0 2:0 2:0 2:0 2:0 2:0 2:0 2:0 2:0 2:0 2:0 2:0 2:0 2:0 2:0 2:0 2:0 2:0 2:0 2:0 2:0 2:0 2:0 2:0 2:0 2:0 2:0 2:0 2:0 2:0 2:0 2:0 2:0 2:0 2:0 2:0 1:1
1:1 2:0 2:0 2:0 2:0 2:0 2:0 2:0 2:0 2:0 2:0 2:0 2:0 2:0 2:0 2:0 2:0 2:0 2:0 2:0 2:0 2:0 2:0 2:0 2:0 2:0 2:0 2:0 2:0 2:0 2:0 2:0 2:0 2:0 2:0 2:0 2:0 2:0 2:0 2:0 2:0 2:0 2:0 2:0 2:0 2:0 2:0 2:0 2:0 1:1
1:1 2:0 2:0 2:0 2:0 2:0 2:0 2:0 2:0 2:0 2:0 2:0 2:0 2:0 2:0 2:0 2:0 2:0 2:0 2:0 2:0 2:0 2:0 2:0 2:0 2:0 2:0 2:0 2:0 2:0 2:0 2:0 2:0 2:0 2:0 2:0 2:0 2:0 2:0 2:0 2:0 2:0 2:0 2:0 2:0 2:0 2:0 2:0 2:0 1:1
1:1 2:0 2:0 2:0 2:0 2:0 2:0 2:0 2:0 2:0 2:0 2:0 2:0 2:0 2:0 2:0 2:0 2:0 2:0 2:0 2:0 2:0 2:0 2:0 2:0 2:0 2:0 2:0 2:0 2:0 2:0 2:0 2:0 2:0 2:0 2:0 2:0 2:0 2:0 2:0 2:0 2:0 2:0 2:0 2:0 2:0 2:0 2:0 2:0 1:1
1:1 2:0 2:0 2:0 2:0 2:0 2:0 2:0 2:0 2:0 2:0 2:0 2:0 2:0 2:0 2:0 2:0 2:0 2:0 2:0 2:0 2:0 2:0 2:0 2:0 2:0 2:0 2:0 2:0 2:0 2:0 2:0 2:0 2:0 2:0 2:0 2:0 2:0 2:0 2:0 2:0 2:0 2:0 2:0 2:0 2:0 2:0 2:0 2:0 1:1
1:1 2:0 2:0 2:0 2:0 2:0 2:0 2:0 2:0 2:0 2:0 2:0 2:0 2:0 2:0 2:0 2:0 2:0 2:0 2:0 2:0 2:0 2:0 2:0 2:0 2:0 2:0 2:0 2:0 2:0 2:0 2:0 2:0 2:0 2:0 2:0 2:0 2:0 2:0 2:0 2:0 2:0 2:0 2:0 2:0 2:0 2:0 2:0 2:0 1:1
1:1 2:0 2:0 2:0 2:0 2:0 2:0 2:0 2:0 2:0 2:0 2:0 2:0 2:0 2:0 2:0 2:0 2:0 2:0 2:0 2:0 2:0 2:0 2:0 2:0 2:0 2:0 2:0 2:0 2:0 2:0 2:0 2:0 2:0 2:0 2:0 2:0 2:0 2:0 2:0 2:0 2:0 2:0 2:0 2:0 2:0 2:0 2:0 2:0 1:1
1:1 2:0 2:0 2:0 2:0 2:0 2:0 2:0 2:0 2:0 2:0 2:0 2:0 2:0 2:0 2:0 2:0 2:0 2:0 2:0 2:0 2:0 2:0 2:0 2:0 2:0 2:0 2:0 2:0 2:0 2:0 2:0 2:0 2:0 2:0 2:0 2:0 2:0 2:0 2:0 2:0 2:0 2:0 2:0 2:0 2:0 2:0 2:0 2:0 1:1
1:1 2:0 2:0 2:0 2:0 2:0 2:0 2:0 2:0 2:0 2:0 2:0 2:0 2:0 2:0 2:0 2:0 2:0 2:0 2:0 2:0 2:0 2:0 2:0 2:0 2:0 2:0 2:0 2:0 2:0 2:0 2:0 2:0 2:0 2:0 2:0 2:0 2:0 2:0 2:0 2:0 2:0 2:0 2:0 2:0 2:0 2:0 2:0 2:0 1:1
1:1 2:0 2:0 2:0 2:0 2:0 2:0 2:0 2:0 2:0 2:0 2:0 2:0 2:0 2:0 2:0 2:0 2:0 2:0 2:0 2:0 2:0 2:0 2:0 2:0 2:0 2:0 2:0 2:0 2:0 2:0 2:0 2:0 2:0 2:0 2:0 2:0 2:0 2:0 2:0 2:0 2:0 2:0 2:0 2:0 2:0 2:0 2:0 2:0 1:1
1:1 2:0 2:0 2:0 2:0 2:0 2:0 2:0 2:0 2:0 2:0 2:0 2:0 2:0 2:0 2:0 2:0 2:0 2:0 2:0 2:0 2:0 2:0 2:0 2:0 2:0 2:0 2:0 2:0 2:0 2:0 2:0 2:0 2:0 2:0 2:0 2:0 2:0 2:0 2:0 2:0 2:0 2:0 2:0 2:0 2:0 2:0 2:0 2:0 1:1
1:1 2:0 2:0 2:0 2:0 2:0 2:0 2:0 2:0 2:0 2:0 2:0 2:0 2:0 2:0 2:0 2:0 2:0 2:0 2:0 2:0 2:0 2:0 2:0 2:0 2:0 2:0 2:0 2:0 2:0 2:0 2:0 2:0 2:0 2:0 2:0 2:0 2:0 2:0 2:0 2:0 2:0 2:0 2:0 2:0 2:0 2:0 2:0 2:0 1:1
1:1 2:0 2:0 2:0 2:0 2:0 2:0 2:0 2:0 2:0 2:0 2:0 2:0 2:0 2:0 2:0 2:0 2:0 2:0 2:0 2:0 2:0 2:0 2:0 2:0 2:0 2:0 2:0 2:0 2:0 2:0 2:0 2:0 2:0 2:0 2:0 2:0 2:0 2:0 2:0 2:0 2:0 2:0 2:0 2:0 2:0 2:0 2:0 2:0 1:1
1:1 2:0 2:0 2:0 2:0 2:0 2:0 2:0 2:0 2:0 2:0 2:0 2:0 2:0 2:0 2:0 2:0 2:0 2:0 2:0 2:0 2:0 2:0 2:0 2:0 2:0 2:0 2:0 2:0 2:0 2:0 2:0 2:0 2:0 2:0 2:0 2:0 2:0 2:0 2:0 2:0 2:0 2:0 2:0 2:0 2:0 2:0 2:0 2:0 1:1
1:1 2:0 2:0 2:0 2:0 2:0 2:0 2:0 2:0 2:0 2:0 2:0 2:0 2:0 2:0 2:0 2:0 2:0 2:0 2:0 2:0 2:0 2:0 2:0 2:0 2:0 2:0 2:0 2:0 2:0 2:0 2:0 2:0 2:0 2:0 2:0 2:0 2:0 2:0 2:0 2:0 2:0 2:0 2:0 2:0 2:0 2:0 2:0 2:0 1:1
1:1 1:1 1:1 1:1 1:1 1:1 1:1 1:1 1:1 1:1 1:1 1:1 1:1 1:1 1:1 1:1 1:1 1:1 1:1 1:1 2:0 2:0 2:0 1:1 1:1 1:1 1:1 1:1 1:1 1:1 1:1 1:1 1:1 1:1 1:1 1:1 1:1 1:1 1:1 1:1 1:1 1:1 1:1 1:1 1:1 1:1 1:1 1:1 1:1 1:1
